0 0 0 0 0 0 0 0 0 0 0 0 0 0 0 0 0 0 0 0 0 0 0 0 0 0 0 0 0 0 0 0 0 0 0 0 0 0 0 0 0 0 0 0 0 0 0 0 0 0
0 2 3 2 1 2 3 1 1 2 3 2 1 2 1 1 2 3 2 1 2 1 1 2 3 2 1 2 1 1 2 3 2 1 2 1 1 2 3 2 1 2 1 1 2 3 2 1 2 0
0 2 3 3 2 1 2 3 3 2 3 1 2 3 1 3 2 3 1 2 3 1 3 2 3 1 2 3 1 3 2 3 1 2 3 1 3 2 3 1 2 3 1 3 2 3 1 2 3 0
0 1 2 3 2 1 1 1 1 2 3 2 1 2 1 2 3 2 1 1 2 3 2 1 1 2 3 2 1 1 1 2 3 2 1 1 2 3 2 1 1 2 3 2 1 1 2 3 2 0
0 1 1 3 2 1 2 3 2 2 3 2 1 2 1 2 3 2 1 1 2 3 2 1 1 2 3 2 1 1 1 2 3 2 1 1 2 3 2 1 1 2 3 2 1 1 2 3 2 0
0 1 2 3 2 1 1 1 1 2 3 2 1 2 1 2 3 2 1 1 2 3 2 1 1 2 3 2 1 1 1 2 3 2 1 1 2 3 2 1 1 2 3 2 1 1 2 3 2 0
0 1 1 3 2 1 2 3 2 2 3 2 1 2 1 2 3 2 1 1 2 3 2 1 1 2 3 2 1 1 1 2 3 2 1 1 2 3 2 1 1 2 3 2 1 1 2 3 2 0
0 1 2 3 2 1 3 3 0 0 0 0 0 0 0 0 0 0 0 0 0 0 0 0 0 0 0 0 0 0 0 0 0 0 0 0 0 0 0 0 0 0 1 2 3 2 1 3 1 0
0 1 2 3 2 1 1 2 0 4 4 4 4 4 4 4 4 4 4 4 4 4 4 4 4 4 4 4 4 4 4 4 4 4 4 4 4 4 4 4 4 0 1 2 3 2 1 3 1 0
0 3 2 1 3 3 1 3 0 4 4 4 4 4 4 4 4 4 4 4 4 4 4 4 4 4 4 4 4 4 4 4 4 4 4 4 4 4 4 4 4 0 1 2 3 2 1 3 1 0
0 1 3 3 1 3 3 2 0 4 4 4 4 4 4 4 4 4 4 4 4 4 4 4 4 4 4 4 4 4 4 4 4 4 4 4 4 4 4 4 4 0 1 2 3 2 1 3 1 0
0 3 1 3 3 2 2 3 0 4 4 4 4 4 4 4 4 4 4 4 4 4 4 4 4 4 4 4 4 4 4 4 4 4 4 4 4 4 4 4 4 0 1 2 3 2 1 3 1 0
0 2 1 3 2 3 3 2 0 4 4 4 4 4 4 4 4 4 4 4 4 4 4 4 4 4 4 4 4 4 4 4 4 4 4 4 4 4 4 4 4 0 1 2 3 2 1 3 1 0
0 1 3 2 3 3 2 3 0 4 4 4 4 4 4 4 4 4 4 4 4 4 4 4 4 4 4 4 4 4 4 4 4 4 4 4 4 4 4 4 4 0 1 2 3 2 1 3 1 0
0 2 3 3 2 3 3 1 0 4 4 4 4 4 4 4 4 4 4 4 4 4 4 4 4 4 4 4 4 4 4 4 4 4 4 4 4 4 4 4 4 0 1 2 3 2 1 3 1 0
0 3 2 3 1 1 2 2 0 4 4 4 4 4 4 4 4 4 4 4 4 4 4 4 4 4 4 4 4 4 4 4 4 4 4 4 4 4 4 4 4 0 1 2 3 2 1 3 1 0
0 1 2 3 2 3 1 2 0 4 4 4 4 4 4 4 4 4 4 4 4 4 4 4 4 4 4 4 4 4 4 4 4 4 4 4 4 4 4 4 4 0 1 2 3 2 1 3 1 0
0 1 3 2 3 2 2 3 0 4 4 4 4 4 4 4 4 4 4 4 4 4 4 4 4 4 4 4 4 4 4 4 4 4 4 4 4 4 4 4 4 0 1 2 3 2 1 3 1 0
0 1 3 2 3 2 1 1 0 4 4 4 4 4 4 4 4 4 4 4 4 4 4 4 4 4 4 4 4 4 4 4 4 4 4 4 4 4 4 4 4 0 1 2 3 2 1 3 1 0
0 2 1 3 2 1 3 2 0 4 4 4 4 4 4 4 4 4 4 4 4 4 4 4 4 4 4 4 4 4 4 4 4 4 4 4 4 4 4 4 4 0 1 2 3 2 1 3 1 0
0 2 3 2 3 1 2 3 0 4 4 4 4 4 4 4 4 4 4 4 4 4 4 4 4 4 4 4 4 4 4 4 4 4 4 4 4 4 4 4 4 0 1 2 3 2 1 3 1 0
0 1 2 3 2 3 1 2 0 0 0 0 0 0 0 0 5 0 0 0 0 0 0 0 0 0 0 0 0 0 0 0 0 0 0 0 0 0 0 0 0 0 1 2 3 2 1 3 1 0
0 2 3 2 3 1 2 1 0 5 5 5 5 5 5 5 5 5 5 5 5 5 5 5 5 5 5 5 5 5 5 5 5 5 5 5 5 5 5 5 5 0 1 2 3 2 1 3 1 0
0 2 3 2 3 1 1 2 0 5 5 5 5 5 5 5 5 5 5 5 5 5 5 5 5 5 5 5 5 5 5 5 5 5 5 5 5 5 5 5 5 0 1 2 3 2 1 3 1 0
0 1 2 3 2 3 2 3 0 5 5 5 5 5 5 5 5 5 5 5 5 5 5 5 5 5 5 5 5 5 5 5 5 5 5 5 5 5 5 5 5 0 1 2 3 2 1 3 1 0
0 2 1 3 2 1 2 2 0 5 5 5 5 5 5 5 5 5 5 5 5 5 5 5 5 5 5 5 5 5 5 5 5 5 5 5 5 5 5 5 5 0 1 2 3 2 1 3 1 0
0 2 1 2 3 1 3 3 0 5 5 5 5 5 5 5 5 5 5 5 5 5 5 5 5 5 5 5 5 5 5 5 5 5 5 5 5 5 5 5 5 0 1 2 3 2 1 3 1 0
0 1 2 3 2 1 3 1 0 5 5 5 5 5 5 5 5 5 5 5 5 5 5 5 5 5 5 5 5 5 5 5 5 5 5 5 5 5 5 5 5 0 1 2 3 2 1 3 1 0
0 2 1 3 2 1 2 3 0 5 5 5 5 5 5 5 5 5 5 5 5 5 5 5 5 5 5 5 5 5 5 5 5 5 5 5 5 5 5 5 5 0 1 2 3 2 1 3 1 0
0 3 1 2 3 1 3 1 0 5 5 5 5 5 5 5 5 5 5 5 5 5 5 5 5 5 5 5 5 5 5 5 5 5 5 5 5 5 5 5 5 0 1 2 3 2 1 3 1 0
0 2 3 2 1 2 2 1 0 5 5 5 5 5 5 5 5 5 5 5 5 5 5 5 5 5 5 5 5 5 5 5 5 5 5 5 5 5 5 5 5 0 1 2 3 2 1 3 1 0
0 2 3 3 2 1 3 3 0 5 5 5 5 5 5 5 5 5 5 5 5 5 5 5 5 5 5 5 5 5 5 5 5 5 5 5 5 5 5 5 5 0 1 2 3 2 1 3 1 0
0 3 1 2 3 1 2 1 0 5 5 5 5 5 5 5 5 5 5 5 5 5 5 5 5 5 5 5 5 5 5 5 5 5 5 5 5 5 5 5 5 0 1 2 3 2 1 3 1 0
0 2 3 2 3 1 2 3 0 5 5 5 5 5 5 5 5 5 5 5 5 5 5 5 5 5 5 5 5 5 5 5 5 5 5 5 5 5 5 5 5 0 1 2 3 2 1 3 1 0
0 3 1 2 3 1 3 2 0 0 0 0 0 0 0 0 0 0 0 0 0 6 0 0 0 0 0 0 0 0 0 0 0 0 0 0 0 0 0 0 0 0 1 2 3 2 1 3 1 0
0 1 2 3 2 1 3 1 0 6 6 6 6 6 6 6 6 6 6 6 6 6 6 6 6 6 6 6 6 6 6 6 6 6 6 6 6 6 6 6 6 0 1 2 3 2 1 3 1 0
0 1 2 3 2 1 2 3 0 6 6 6 6 6 6 6 6 6 6 6 6 6 6 6 6 6 6 6 6 6 6 6 6 6 6 6 6 6 6 6 6 0 1 2 3 2 1 3 3 0
0 1 2 3 2 1 2 1 0 6 6 6 6 6 6 6 6 6 6 6 6 6 6 6 6 6 6 6 6 6 6 6 6 6 6 6 6 6 6 6 6 0 1 2 3 2 1 3 1 0
0 3 1 2 3 1 3 2 0 6 6 6 6 6 6 6 6 6 6 6 6 6 6 6 6 6 6 6 6 6 6 6 6 6 6 6 6 6 6 6 6 0 1 2 3 2 1 3 2 0
0 1 1 3 2 1 3 1 0 6 6 6 6 6 6 6 6 6 6 6 6 6 6 6 6 6 6 6 6 6 6 6 6 6 6 6 6 6 6 6 6 0 2 3 1 2 3 1 3 0
0 1 1 3 2 1 2 2 0 6 6 6 6 6 6 6 6 6 6 6 6 6 6 6 6 6 6 6 6 6 6 6 6 6 6 6 6 6 6 6 6 0 3 2 1 1 2 3 2 0
0 1 2 3 2 1 2 3 0 0 0 0 0 0 0 0 0 0 0 0 0 0 0 0 0 0 0 0 0 0 0 0 0 0 0 0 0 0 0 0 0 0 2 3 1 2 3 1 3 0
0 3 1 2 3 1 3 2 3 1 2 3 1 3 2 3 1 2 3 1 3 2 3 1 2 3 1 3 2 3 1 2 3 1 3 2 3 1 2 3 1 3 2 3 1 2 3 1 3 0
0 1 2 3 2 1 1 1 1 2 3 2 1 2 1 2 3 2 1 1 2 3 2 1 1 2 3 2 1 1 1 2 3 2 1 1 2 3 2 1 1 2 3 2 1 1 2 3 2 0
0 1 1 3 2 1 2 3 2 2 3 2 1 2 1 2 3 2 1 1 2 3 2 1 1 2 3 2 1 1 1 2 3 2 1 1 2 3 2 1 1 2 3 2 1 1 2 3 2 0
0 1 2 3 2 1 3 2 3 1 2 3 1 3 2 3 1 2 3 1 3 2 3 1 2 3 1 3 2 3 1 2 3 1 3 2 3 1 2 3 1 3 2 3 1 2 3 1 3 0
0 3 1 2 3 1 2 2 3 1 2 3 1 2 2 3 1 2 3 1 2 2 3 1 2 3 1 2 2 3 1 2 3 1 2 2 3 1 2 3 1 2 2 3 1 2 3 1 2 0
0 3 1 2 3 1 3 2 3 1 2 3 1 3 2 3 1 2 3 1 3 2 3 1 2 3 1 3 2 3 1 2 3 1 3 2 3 1 2 3 1 3 2 3 1 2 3 1 3 0
0 1 2 3 2 1 2 1 1 2 3 2 1 2 1 1 2 3 2 1 2 1 1 2 3 2 1 2 1 1 2 3 2 1 2 1 1 2 3 2 1 2 1 1 2 3 2 1 2 0
0 0 0 0 0 0 0 0 0 0 0 0 0 0 0 0 0 0 0 0 0 0 0 0 0 0 0 0 0 0 0 0 0 0 0 0 0 0 0 0 0 0 0 0 0 0 0 0 0 0
